00000000000000000000
01111111011011111110
00000100011000100000
11010101111110101011
00010000000000001000
01110111011011101110
00000000011000000000
11110101111110101111
11110100000000101111
11110101111110101111
11110001000010001111
11110101111110101111
11110100000000101111
11110111011011101111
00000100011000100000
01110101111110101110
00000000000000000000
01110111101011101110
01110111101011101110
00000000001000000000

